########
# ooA@o#
#o @   #
#  @ @##
#o#    #
# #@@# #
#o @ o #
###### #
     # #
###### #
####o@ #
### o  #
### @  #
########