##########
#  o     #
#  o  @ ##
#  @   ### 
#  A  #     
########## 
