########
#o  ## #
#A@@   #
#  o o #
# @  @o#
# o  @ #
###    #
########