#######
#oA # #
#@o @ #
# @ @ #
# oo  #
#  o@ #
#######